11100111100111100111
1              0   1
1        0011111   3
1  0011111         1
1           11     1
3                  1
1   12211110111    1
1             1    1
1        22   1    1
1011112       1    1
1    11       1    1
1     1       110001
3     1            3
1     1       111201
1     1            1
1     1      0     1
1   2111121111     1
1         00       1
1   2           2  f
11100111100111100111