11100111100111100111
1              0   1
1     1111100      1
1 1001111          1
1                  3
1          301111111
1   11      1      1
1            111   1
1   1    1         1
10111   001111     1
1                  1
1        1 1 1     1
3     00      1   f1
1    1     1   1   1
1     1    113110111
1           000    1
1      111101111   1
1                 11
1     00     11   11
11100111100111100111