11001111111110011111
1                  1
1                  1
1                  1
1           11     1
1                  1
1                  3
1                  1
1                  1
1                  1
1    11            1
1                  1
3                  1
1               22 1
1                  1
1                  1
1   222            1
1                  1
1                  3
11110011111001111111